111111111
100100001
100010111
100000001
111111111